000000000000000000000000
000000000000000000000000
000000000000000000000000
000000000000000000000000
000022222000000000000000
000000000000000000000000
220000000002200000022000
112222222221100002211200
111111111111100001111100
111111111111100000100000
111111111111100000100000
111111111111100000000000
